
SO ./path_to_the_south_texture


NO ./path_to_the_north_texture



WE ./path_to_the_west_texture
EA ./path_to_the_east_texture

C 165,42,42

R 600 400


S ./path_to_the_sprite_texture
F 135,206,235



111111111111111
100000000000001
122222200000001
122222200000001
122222200000001
122222200000001
100000000000001
1000000N0000001
100000000000001
100000000000001
111111111111111
